Node	Type
CDKN1A	Down
CELECOXIB	Drug
MELPHALAN	Drug
PACLITAXEL	Drug
CARBOPLATIN	Drug
NICOTINE	Drug
FLUOROURACIL	Drug
CLADRIBINE	Drug
DIAZIQUONE	Drug
DICUMAROL	Drug
EPOETIN BETA	Drug
CYCLOSPORINE	Drug
VINBLASTINE	Drug
ROMIDEPSIN	Drug
ACETAMINOPHEN	Drug
DEOXYCYTIDINE	Drug
IRINOTECAN HYDROCHLORIDE	Drug
PENTETIC ACID	Drug
FLUTAMIDE	Drug
FZD7	Up
VANTICTUMAB	Drug
SLC39A14	Down
NORTRIPTYLINE	Drug
